1111111111111111111111111111111111
1010010100100000101001000000010101
101001C01011010000100100E000010101
10000000C0000000000000000000000001
10CCCCCCCCCCCCCCCCCCCCCCCCCCCCPC01
1111111111111111111111111111111111