111111111111111111111111111111111111111111111111
101001010010000010100100000001010000000000000001
101001001011010000100100000001010000000000000001
1P0000000000000000000000000000000000000000000001
100C0000000000000000E000000000000000000000000001
101001010010000010100100000001010000000000000001
101001001011010000100100000001010000000000000001
100000000000000000000000000000000000000000000001
100C0000000000000000E000000000000000000000000001
101001010010000010100100000001010000000000000001
101001001011010000100100000001010000000000000001
100000000000000000000000000000000000000000000011
100C0000000000000000E000000000000000000000000001
111111111111111111111111111111111111111111111111
