1111111111111111111111111111111111
1010010100100000101001000000010101
1010010010110100001001000000010101
1PW0000000000000000000000000000001
100C0000000000000000E0000000000001
1111111111111111111111111111111111
