1111111111111111111111111111111111
1010010100100000101001000000010101
1010010010110100001001000000010101
1000000000000000000P00000000000001
1000000000C000000000E0000000000001
1111111111111111111111111111111111