1111111111111111111111111111111111
1010010100100000101001000000010101
1010010010110100001001000000010101
1000000C00000000000000E00000000001
10000000000000000000P0000000000001
1111111111111111111111111111111111